>TP137_hit_64
TGCAGAAAAAATCAGTTTGCATTTACAACACATGAACACCAAGTCTGACATAGGTAGATCATCT
>TP603_hit_64
TGCAGAAAAGAGAACAGAAAAAAAGTAAAAGTAAAACGGAGGAACTTCACCAAAACGACGGTTA
>TP1106_hit_64
TGCAGAAACAGGAGGCCTTCCTTGTCCTGGGAGCATGACAACCAGACCTCCCAGTGCAGCAACT
>TP1667_hit_64
TGCAGAAAGAGTTAATTCACGTGTGAGACCAAGTTTACGTGCATGTGTGGTTTCGATTGGCAGC
>TP2117_hit_64
TGCAGAAATAGTTTTTTGTTTCTCCTTGGTCGACTTCGGTGTGATTAAGTCTAACTACTCCTAC
>TP2921_hit_64
TGCAGAACACTCATCTCTGTCATAGGAACAGTGCGAAAATCCATAGTGGAGTAGTAAGTCGCAG
>TP3417_hit_64
TGCAGAACCTTGTTCTCTTACTCAGTCCTTCATACGGCGCCTTGTCCCTGCTGTTTGTAGGCCT
>TP6457_hit_64
TGCAGAAGGTGTCGTTTGAATTGCGCGAAGAAGTCTTGCCACTTAGGAGTTTGGAACTACCCTG
>TP6503_hit_64
TGCAGAAGTACACGGTGAAACTGTCGCGATTGTAAGCTGCTGATAACCTCCAAGAGATGAGGTT
>TP6735_hit_64
TGCAGAAGTGGCATTTGACAAGTTACATGTTCATATTATTAAAAGTATACTAGTCTGTACCGAA
>TP8402_hit_64
TGCAGAATTATCACATCCTAGTGTCAATTCTCTGAAGACAAAACAAGAACTCGTACCAATTGAA
>TP8736_hit_64
TGCAGAATTTCTCTTTCAGAAAGGATGGGGAACTGAGCCTGGATTCCTCCCGTCACTGTCAGCA
>TP9031_hit_64
TGCAGACAACGGTTCCCATCGTGCAGCGTACGAGGCAGTCTTGCGCCACAGCCCCTGTATATTG
>TP9263_hit_64
TGCAGACACACAGAGAAAGATCATGACTTCTCCGAATAGATAGGACCGAATTTAGCTTGGCATG
>TP9461_hit_64
TGCAGACACGGCACAACGACGATAGTGTCGTGACACGATGGATGCGAGCGCGCGCACCGAGTAC
>TP9836_hit_64
TGCAGACATAAAACATGCAATGTTTATATATGGAAAGCAAAGGAATTAACGTACTTTTCCTGTT
>TP10886_hit_64
TGCAGACCGACCACATGGTGAACGTCGTCCCCATGCTGAATCTCCGATGAGGTCTGCTCAGTCA
>TP11360_hit_64
TGCAGACCTTGGCTTCACCTCCCGCGTGTTCATACCAGAGCTCTCGGCGTCGCCACGGTCGTCT
>TP11969_hit_64
TGCAGACGCATGGTTTTATCCTCATCTCCCTGTCCCCACCACATGAAAGATGGGCAGTAGGTAC
>TP12869_hit_64
TGCAGGCGTGTCCTCAGACCACAGCCGAATTAGAGCTTGACACTCACCTTTCCATTTCCAACCC
>TP14537_hit_64
TGCAGAGATAACTCAAACAGCGAATCCATGGTTGGCTGCTCCAAACCTGCGCAACCCCCAAATC
>TP14974_hit_64
TGCAGAGAGAGTCAGAGAGGGAGAGGCAGAGGGCGGTACCCACATGAGGCGAGGGGAGCTCGGC
>TP16151_hit_64
TGCAGAGCAGGGGAGCTAAAAATCCTACAGCTCAATGGCGATCCTGTGAACCCTTTCCTTGGGC
>TP16906_hit_64
TGCAGAGCGCCAAGGCGACGGCGGTGCATCAGTTCCTGGGGTCCGAGGAGTACAAGCGGCGGCT
>TP17385_hit_64
TGCAGAGCTGCACACCCGCTCACCGAAGCCATCACCGCCCATACAACAACGACATCGGCGTTGT
>TP17646_hit_64
TGCAGAGGAAATTATTTCATGGTGGGAAATCGGTTCAACATGAACATGGACATCAAGGAAGCGT
>TP17656_hit_64
TGCAGAGTAACAGTTACATCAGTACAAAGTAGCAAGGACAACTGCTGCATCAGTAAAAACAATT
>TP17721_hit_64
TGCAGAGGAAGCTATCCATACCCACATTGGGAAGAAGCGACAGTGGAGGAACACACATGCCCTC
>TP17778_hit_64
TGCAGAGGAATGGGCAGCGCGCCAGTACCAATGCAGGGGTGGCTCTTCCTCGGGCGAGAGGCGC
>TP18138_hit_64
TGCAGAGGAGTCACGCTCATGCATGCATGCACACACACACATATGAACATGCATGCATGTGAGA
>TP19363_hit_64
TGCAGGGGGTTAATCGCCGTGTCGAATAGTTTCGCTCTTTGCCTGTCCGACCTGTATGTATATT
>TP21383_hit_64
TGCAGATAAGTAGTACAATGATATTGTTTCAAGAATCTTTTATAGTATCATTCTGTTCATGTAC
>TP22088_hit_64
TGCAGATATAAATGCTCAAGCCTCAATGGCCTGGTCATAGCAGTAAAGGGCACGGTGGAGCCAA
>TP22496_hit_64
TGCAGATATTGTCGCTCATGGAGCTTGGGCTGGAGCTCAACGTCCAGGAGGATCACACTCTTAG
>TP23854_hit_64
TGCAGATCCTCGTCGAGCTCAAGGCCGCCGTCACTGAGGCGCGGCGTCGCGGGGGCTCATCGGC
>TP24137_hit_64
TGCAGATCGATTCATGATGGCGCCTGGCGGCGCCTGGGCGATTAGGGTTTTGACCATGGAACCG
>TP24789_hit_64
TGCAGATCTGCCGCCTCGTCGTCTATATGTTTGTCTCGGCGTCGTCTACTCATCCGTGTCACCA
>TP26713_hit_64
TGCAGATGGATGCGCGATGGATGGATGTGTGCTTCCTCCTCTTTTGCGTCCCTCCCCCAGGGAT
>TP26994_hit_64
TGCAGATGGGCGTGGGGCCGCTCAAGGTGGCTGGCGCTGTGCAGCCTCCTCGGCGCGCCATCGT
>TP27007_hit_64
TGCAGATGGGGACGCGCGCGCTCGTCTACGTACCTTGGCCAGGGAGGAAGAAGCTGGGGCGGCG
>TP28911_hit_64
TGCAGATTGATAATTTGAAAAAAAATCGATAACGATATTATGATTTATCCTTATCTTTTGTTTT
>TP29080_hit_64
TGCAGATTGGATGGATGCTCCATGCACCAGAAGCTCCTCTTCTTTCTCTCTTCAGGGAGCGGCG
>TP29374_hit_64
TGCAGATTTACTGTAGAATGTTGTTGTAACGTTTAGAAGATAGCTCAAAATGCTTATTCTGCCG
>TP31443_hit_64
TGCAGCAAATTTGATCCAAATTCCTCTTCTCCTTTTCAGTTTGTGCAGGATTTGGTTGCCGTGG
>TP32523_hit_64
TGCAGCAACGCTCCTGCTGTGAACAACTTTTCAACCACCATTGATGCTCCATTCTGCACTGTCG
>TP32678_hit_64
TGCAGCAACGTCGCCGACGTCTCGCTCCCCGCCATGAACATGTCCTGTCCGAAAACAGAGAGAG
>TP35390_hit_64
TGCAGCAATCGTACCAAACAAACAGAAACTGCAATGAATAGTCTGGGCCACGATCTGACAGCAA
>TP35964_hit_64
TGCAGCACGAACCACCACCTAGACAACATCCGAAGTCCTAATTCTCCAAAAACGACGCCTCCAG
>TP36049_hit_64
TGCAGCACAACCAAACCCAAAAGGAAAAAACAAGAGAAAGAAAAGAGAAACACATGTCGACACC
>TP36311_hit_64
TGCAGTACACCAAACATAATCACAAGGAGGTTAACAAAACCGATATATTAGTAATACAAAATTC
>TP38324_hit_64
TGCAGCACCTGCTCGTTGCAGCGGACATGTATGACCTCCCAAGATTCAGGGCAATGTGCGATAA
>TP38651_hit_64
TGCAGCACGATAAAAAGTGTCTGGCTCAGAAGTTAAAAGACGCTGGTGCTGGGCCCCATGCATT
>TP39001_hit_64
TGCAGCACGCGCTTGAGGAGGCCCCCGACGTCGTTCCTGCCGTCGAACGCCTGGGACACGGACA
>TP40566_hit_64
TGCAGCAGAAGAATCAAGATCTGACTCGATCATAAAGCGTGTGTACTCCTTGATCTCGTCGTTG
>TP41599_hit_64
TGCAGCAGATTGTCGACGTACCGCACACCGATATCGATCAAAAGGGCCAGCCCATCTGTCCGTT
>TP42286_hit_64
TGCAGCAGCAGCAGCAAACAACATAAGCGAGTAGAGTAATGAAATCCACAATGGAATCCAAACT
>TP44622_hit_64
TGCAGCAGCTCCCGTGCAGCCTCCCAGCCCGTGGCGTCTCCGTCGTGCCTGCTGGGGAAGTGCC
>TP44690_hit_64
TGCAGCAGCTCGCCCAGCTTGCTCGGCAGCGCCTCCACCATGCCCGACAGCGCGCCCACCGCGA
>TP45471_hit_64
TGCAGCAGGAGCAGAGATGCACCAGAGAAGAAGGAAAGGGGATTACACTTATTGTTGTGCCTTG
>TP46060_hit_64
TGCAGCAGGCTAGCCCTGCTACCGCACTGACACTCCTGCACACCGCCAAACCCTCCACACGCCG
>TP47630_hit_64
TGCAGCAGTGCATGCGGGGTGTTATTGTTGGCGCAGGATCTCCTGCTGCGCAGAAGGGCCAAAG
>TP48114_hit_64
TGCAGCATAAATGAACAATACAGAATGGCAAAATCAACATTATGGAATTGGACATCTTGCACAA
>TP48319_hit_64
TGCAGCATAGCTACCGTCAATATCTCCATTTGTTGAATTTGTGTATAACATGACCACAACACAC
>TP48525_hit_64
TGCAGCATATGTAGGCGCGAAGGGCACAAGAAAACGACATGCCCAGATAGAGGGGATATGCCGA
>TP48658_hit_64
TGCAGCATCACATCTTCAATGGTTTCTTCGCCTCCTACAAATAGAGGGAGAGGAAAGGGATGCC
>TP50734_hit_64
TGCAGCATGTAAAACGATACAACAAATTTGTTTTCAGCGACACATTTGCAAGCAGACTTTTCTT
>TP51433_hit_64
TGCAGCATTGTGTGACCAAATTCAAGTGCATAGGTGATCATGCCAATGTTCGATCTTGTGTTAG
>TP51971_hit_64
TGCAGCCAAAGGATTCCCATCTAGAAAAGAGCCAAGCAATCTTCATCCCCGTCCCAATCAAAGA
>TP53887_hit_64
TGCAGCCACGTCGACTCGAGACAGATACTGTACGTACAGGAAAATGAACTAGCAAGTGCATTTT
>TP56563_hit_64
TGCAGCCCAAGCACCCAAATGATATTTATGCACTCATGCACATGGGTTGCATGACCGTGACGGA
>TP57074_hit_64
TGCAGCCCAGCCTCCGATTGGACGAACCGCACCTACTACCAAAGCAGCGTCCTCCGATTGGGAT
>TP57781_hit_64
TGCAGCCCCACAAGGACCCTAGTACACGGACTTATCCAACAGGGCACTCCTGTGGCAAGGTCGC
>TP58544_hit_64
TGCAGCCCCGCCGTTGGCCCCTACCACACCACCGCCCATGACTGCCGTCCACCCGACCACTGCG
>TP59010_hit_64
TGCAGCCCCTTTACGTCATATACACTAGATAGTCAAAAGGCGGGCACATACATATGGTCGGAGC
>TP59876_hit_64
TGCAGCCCGTCTTCAAGGACTCCAGCCATTGGGTCAAAATCTCCCCACCCCTCGAGCGAATCTC
>TP59956_hit_64
TGCAGCCCGTTCTTCCAATTGAGTGTGCGTGTGCAGCGGCGTCCCCTGCACTCGCTCACGTCGC
>TP62155_hit_64
TGCAGCCGCATATTATAAATCTAACGTCTCAAACGTTCGTAGATGTGCCCGAACTCATCTGCGG
>TP65915_hit_64
TGCAGCCTCGGACAAACACAGTCGATCTATAGCAGGAAAAGAAAAGTTTAGTTCCAGAAGGCAG
>TP66173_hit_64
TGCAGCCTCTCGACGCAACTCCCCATGAAGGGGTGGCGGCGCACATGGTCTTCACGACCGTCGG
>TP66202_hit_64
TGCAGCCTCTCGTCCTACTGCTGGACGACTGAGTCCAGTCGGCCTATAGGAGGACGGCAAGTGG
>TP70885_hit_64
TGCAGCGATCCGCCCGCGCCAGATCCAGCGAGCCATGGGAGAAGAGATCCTGACGCCGCTGACG
>TP73293_hit_64
TGCAGCGCCGCCGTCGAGTCGCCATGGGCTCGACCTCTTGTGCCTCCTCCTCACCTCCCTTGCC
>TP73368_hit_64
TGCAGCGCCGCGGGTCGGGGCCGCGGGACACGGGCGTGACGGGCACGGGCGCGCGCGCATGATT
>TP74979_hit_64
TGCAGCGCGTTAGTTGAGCTCGGCCCATTACCTTTTTGTTAGCAATCCTGTACTGCTTGTATTT
>TP75357_hit_64
TGCAGCGCTGAATAGGGGGAGCTCCTGTTCGCCGCCCGCGAGCGGCAAACGATTGAGCCTTCGC
>TP75655_hit_64
TGCAGCGCTTCAGATCCACCCCCGAAGTCGCTTCGCCTGTAACATCAAGGCGCAATCCCAAGTC
>TP82325_hit_64
TGCAGCGTGCAGTGCAGGAGGACGGGCTTGTACATGATCCCTCGAAGGGCTGGCAGCATCCAAC
>TP83170_hit_64
TGCAGCGTTCCTGCACAAACACACGCGACGCACACACGCGCACCTATGCGCCATAAACCTGAAG
>TP84737_hit_64
TGCAGCTACCGCATGCAAACCCGTCAAGCCAAGAACTGTGATTTCATCAGTCAGCTCCTTGAGG
>TP85977_hit_64
TGCAGCTAGTGAGTGCATGTCACTAGCTGTAGCTTGCAGGCATTCTGTAGAAGCTTTACGCCTC
>TP86651_hit_64
TGCAGCTATTTGACTGGCTCAGATATTTGAATTCAAATTTTGCTTGGAAGTTTCAATCCATATT
>TP87237_hit_64
TGCAGCTCACTAGGGAGCAGTCGACGTTGCCCCGACCACCTCCGTCGTCCCCGAGCTCCCCTGA
>TP89364_hit_64
TGCAGCTCCTAACGAGAGAGACCGTAACAGGAGACGGCGGCGGCGGCGTGCGCACATGCCGTGC
>TP89715_hit_64
TGCAGCTCCTCTCGGTGTCCTCGTTGCCGCGCCTCCAGTACCCTCTGGTGGCCGTCCTCATCGC
>TP90364_hit_64
TGCAGCTCGATGGCCGTGGAGGTCAGCGGTAGCGCGGAGTAGTTGGAGTTCACCATGGTGCCCG
>TP90617_hit_64
TGCAGCTCGCCGCCAACGAAGCCGCCACCACCTCCTCGCCACCAACACAAGGGAGCAGTGTCGC
>TP91711_hit_64
TGCAGCTCTAAATAGTACTTTAAACGTTAGCGCTGCCTTTAAGTTCTACTCAGTTATTAGGCTG
>TP99904_hit_64
TGCAGCTTCTGCCTGTGAACGACGGCAAATCCTTCCGACGGTTATCGTCGTGCTGGCCTACAGC
>TP101165_hit_64
TGCAGCTTGGTTGTTGTGGTCTATCGTGGATGTCGCTCGCACTGAATGTCGGTCTGTCTTGACT
>TP101877_hit_64
TGCAGCTTTGGTGGCCTGCTCTTTGGTCTCATCCATGGTTGAGTCGGCAAGAACAATATCTTCC
>TP102007_hit_64
TGCAGCTTTTGCCCACCACCAACATGCACCACCATGGTCTTAGAGCCACCACCACTGTCTCATC
>TP104102_hit_64
TGCAGGAAGAACACGCGACGCAGCGTGAGATCCAGCGAGGAGAGGAGAGGAGACGAGACGGATG
>TP106602_hit_64
TGCAGGACGACAAAGATCAGCTCAACGTCGGCTGCTTCGCTGTGCCAGTGCTGCATTTTGGCTG
>TP107940_hit_64
TGCAGGAGAGAGACGACCGAGTCTGCGTGGAGTCTGCGTGCAATCCTGTGCGTCGGAGGACAGC
>TP109365_hit_64
TGCAGGAGCGTCTTCCTCCTCTTCCCGCAGGTCGCTTGGTAGCGAAGCCTGTGCTGCTTCAGGA
>TP109425_hit_64
TGCAGGAGCTATGGTCGAGTTTAGTGTCGTCGCGAGCCGCGCGCAGCGCCAGCGGCGACGATGA
>TP109682_hit_64
TGCAGGAGCTGGTCCCCAACGCCAACAAGGTAAAACAATCACATCCCCGACGAGAATCTGTCAT
>TP109791_hit_64
TGCAGGAGCTTTTCCTTCATGCGTTCATAACCCCTTGCTACTGTTCCACGTGGTCGCCGCCACC
>TP113258_hit_64
TGCAGGATGTACGTACAGTACTTGTTAGCGAGTCAACCACACTACCGTACCAATGGGCGAGGCA
>TP114595_hit_64
TGCAGGCACCCGTTAGCGAAAATGCACTATAACCTGGCGTCCTATGCGCCGCATTATGCGTCAA
>TP114776_hit_64
TGCAGGCACGGCATTATTAAACGATGGAGTGTCATCCAGGTGGAACTAGCTATCTCACGACCAA
>TP115005_hit_64
TGCAGGCAGAAGCTTAAAAAAACGAAATAAAAACGAAGAACGCCGAATCTGCACTACATGCAGA
>TP115040_hit_64
TGCAGGCAGACGCTCACTTCAGCGTGCTTAGCATTGTAATTTGCAATACGAGCTCAGATATACA
>TP115215_hit_64
TGCAGGCAGCAGGCTCCCTACAGGTCCTTGCTGCGTGCGCACGCTCTTGTTAGTTTCTTCTGCG
>TP116583_hit_64
TGCAGGCCACCTGCCCTTCTCCTAATGGCAAGGCCAAATTCCCATGGCCTTGGTGGCTAACCTC
>TP117260_hit_64
TGCAGGCCCATTAGAAAAGGCCCAAGCTGGAACGAAACGTTATCTCTGTTCACAGGGACGTGGC
>TP117529_hit_64
TGCAGGCCCTACGTTGTTTCAAGGGACGTAGAACACTGGAATTACCACAATATATTGACTGAAT
>TP118111_hit_64
TGCAGGCCGCAGGCGCCGCCATCCCCTAAGGCAACCCCCTTACCCCTCCCCTGCACCGATGCCG
>TP118270_hit_64
TGCAGGCCGCGCTGTCCGACGCGCACCGCCGCTTCAGCATCCGCACCGTCCGCCTCCTCATCTT
>TP118502_hit_64
TGCAGGCCGTCGCGCTTGCAATGTCGCCGTTTACAAACTTGCTGGCACACATTTGGGTTCAAAT
>TP118652_hit_64
TGCAGGCCGTTTACCTAAGTCTCCACACACCTGTACCCTACAGCTGGTCGCCACACGCCTGGAG
>TP122344_hit_64
TGCAGGCTAGCAGTGATCTGACTTTGGTCAACACAGTTTCAAGCAAAGATGTAGACAAGTTGGC
>TP124333_hit_64
TGCAGGCTTGCAGGGAGCGTCTTCAGAGCAGAACAGTGTTCAATGCGAAGATGTTGGAGAGATG
>TP124815_hit_64
TGCAGGGAACTGGCACCATGCCGCTGCTAAGCAGGCAAGCAGTTGGAGTTAGTAAATACTCCGA
>TP125288_hit_64
TGCAGGGACAGAGCCACCATGCATGCCATTCTGCTGCACTGGATTAGGCTCTGTGTCCCCAGCA
>TP127143_hit_64
TGCAGGGCAATGGGACGTGGGTCGAGCAGTGGTTCCATTACTGTCAACCCAGATCGTCGAGGAG
>TP128487_hit_64
TGCAGGGCGATGGGATGTGGGTCGAGCAGCGGTTCCATTACTGTCAACCCAGATTGTCGAGGAG
>TP128748_hit_64
TGCAGGGCGGAGACGGCGGATGACTGGAACCGCAGGTCGGTCTTGAAGTCCTGCGCGATTTCCC
>TP130342_hit_64
TGCAGGGGCACAACATGGTATGCTTAACACCGACGCTTGTCGCTTGATGCCGCTCCAAAATTTC
>TP132864_hit_64
TGCAGGGGTTAGTTCCATGTGGGGAACAAACCCCAGCAACCGAACAAGGCCTTTTGTTGTCTTT
>TP134212_hit_64
TGCAGGGTGCGCCCAATCCATGGCGAGGCGAGCGTTCTCGATCAGTTGGCGCATGCTGATCGGC
>TP134276_hit_64
TGCAGGGTGCTCGAGAAGCAGAAAGTGGACAGCGAGCAAGACACCGTCCGCTCTTCCTTGCTGA
>TP135505_hit_64
TGCAGGTAACTGAGAGAGTAGTCTGCGAGGGACTTGCATGCATGGCGCCCCTTCTTCCTCCCTC
>TP136775_hit_64
TGCAGGTATGACTGGGCTGCGAAGAAGAGCCTGCGATCTGGCTATTTCCTGTGGTCGGCGTCGG
>TP137157_hit_64
TGCAGGTCACAGGGAGAGTGTCGGCATGGGGTAAGAAGGGATGCAGTCGGCGGCGAACCCACAA
>TP137318_hit_64
TGCAGGTCAGAAAGCTAGCAGATTCTTCGAGAATCGCTCCCACAAATCCCGAGCTCCATGATGA
>TP137744_hit_64
TGCAGGTCCAGCCGACCCCCCTCCTAATCCCTCTCTAAGGCCCTGGCCTTTTGCTTCTCCACTG
>TP138185_hit_64
TGCAGGTCCTCGCTCCTGCGCCGCCGCTCCCTCTAACAAGATGGGTTAGAGCGTCTCCAGCCGC
>TP138381_hit_64
TGCAGGTCGACCAATATCTTGTCCACGCTTTACAACATTGACTGCTGGGGCGTGCTGCCGCTGC
>TP138583_hit_64
TGCAGGTCGCCAATGGAATCAACGATCAAGCCAAGCGTGGCAACCAACAATCAAGGCTGAGAGA
>TP139338_hit_64
TGCAGGTCTGGGATTTTAAGAGTTGCAAGCTAAAATCCAAATTCAATGTTGGTAAATCTGTAAC
>TP140184_hit_64
TGCAGGTGCAAGATCAACGTCAAGGGGTTTAAAAATGGAGGAACGGCACATGCAAAGTTGGCCA
>TP140365_hit_64
TGCAGGTGCAGGTGAGTAATCCTGACTCCTGAGGACTCAAGAATTGATGTGACATGCTCTTTTC
>TP141219_hit_64
TGCAGGTGGAGGCAGGGAGGAGCACGGAGCAACAGGAGCTGCATCGCGCCGCCGCGTTGAGGAG
>TP142196_hit_64
TGCAGGTGTAATCATTTTTCCCTTTACACGCACGCACGCACGCACGCACGCAAGCTTCCTCCCC
>TP142256_hit_64
TGCAGGTGTATGGCATCATCGCGGCACGAGATGTATTGGATCACAAGCGCAACATTCTTTTCCA
>TP142580_hit_64
TGCAGGTGTTAGCTTCCACACTAGAATGTCCTGAGCAGCAGTAGTAATAATAGGAGCCTGAAGA
>TP143632_hit_64
TGCAGGTTCTGACGAAGTATCTTTACTGAACGAGAACGTACCAACACACGCTGACAAGCTTCTT
>TP145458_hit_64
TGCAGTAACAACCTATTGAAACCCTCCATTTACATTTTGACTGATCAAACAAGATGATAAGGGC
>TP146350_hit_64
TGCAGTACAATCGTTTCCTTAAAAGGAGGAACAGCTATCTGTTACTCTTCCATCTGTTTCGGTG
>TP147866_hit_64
TGCAGTAGAAAATGCGGCGGAATCCCCGTCCTACCCTCCCCAAACTCCCTATGTACAGCGTCCA
>TP150530_hit_64
TGCAGTATGGGGAATCTCCAACATAGTGGTGGAATCGGATTGCCAAACCCTCCTGCACGCAGTA
>TP151553_hit_64
TGCAGTCACCGCCACGTGTACCTGTGATCGATCAGGCGACAGCAGCTCTGGATCGTGGCCATCG
>TP152424_hit_64
TGCAGTCCAAATGTCGTATCCTAAACCTACAACGGGTACCAGTAGTCTACTGACCACACGCGCA
>TP157427_hit_64
TGCAGTCTTCTCTGAATTCACGAGTTATTATTCAGAGATTCCCCACCCCCTCTGAACTCAGCAG
>TP157688_hit_64
TGCAGTGAAAAGGACATGATATGTGGGTAGAATTTGGCCGTATCTGGCGCCTTCTCCAGTTCTT
>TP159597_hit_64
TGCAGTGCACCGCGACCCTGCTCTCTTTTTCCGCGGGAAGGCTCTTGCTTTTGCATTTGTGCCG
>TP164057_hit_64
TGCAGTGTAGCGAAACAGGGAGCTCCTATGTGCCGCATTTTGTGGCGAATAGCCAGTGCGATGC
>TP164058_hit_64
TGCAGTGTAGCGATTGTTTCTATTTCTCTCAGTAAAAGAGAATAATTTCTCAGTTTCTTCTCCG
>TP164724_hit_64
TGCAGTGTGCCGACACGTCCTCGATCGAGACTTAGCTAAAAAAGCATATCGACATCGTGAAGCG
>TP164851_hit_64
TGCAGTGTGGCCTGCTGCTACTGTAACATCCACAGGTTTCCACCTGTTTGTGAAAAGTGCTGCG
>TP165885_hit_64
TGCAGTTACGTGTGGGGTGACACATGGAATTTACACGAAGGAGCGAGGATGTAATTATAGTTGC
>TP166569_hit_64
TGCAGTTCGAGCTCCTCGCTGTCACTCCGATGATGGCCGACATGTGCCTGCTCTTCGCCATGCC
>TP167363_hit_64
TGCAGTTCCATCACTGCATCTTCAAAATGCATGGGTTACCAAGTTCTTTAACCCACTTAGGAAT
>TP168492_hit_64
TGCAGTTCTGGGTGGACCATATCAGTGAAATGCGTTTTCCTGGAATGCAAGACGTAGGATTTTG
>TP170445_hit_64
TGCAGTTGGTCTTGATGTGATGGGGTTCATCGGAGGCACACAGAACGGGCAGCGGCCACTGCCA
>TP170463_hit_64
TGCAGTTGGTGAGGTGGGAATCGTGGGAAGCTAGGTATTTCTCTATTAGAGGAGAGTGGTTTAT
>TP170875_hit_64
TGCAGTTGTGTCAGCAGCAGAAACAGGGGAAGTGAAACGTCTGCTCGTAATTATCACACATTTT
>TP172825_hit_64
TGCAGTTTTAGCCCCTCACAGATTTTCCTACCAAATATGTATCATAAATTTTTGCGTGGAGATG
>TP172845_hit_64
TGCAGTTTTAGTTATGAAAGTAGGAGCTCAAACTATGAAGCTCACAACTTAGCGAAGCATGCTT
>TP173010_hit_64
TGCAGTTTTCTAATTTTTTCTATCGCGCACTAAAGAAAATATCATGTTCACTCGCCCCAGTGGG
